border_size=1
usage=map

Wo          , Wo          , Wo          , Wo          , Ww          , Ww          , Ds          , Hh          , Mm          , Mm^Xm       , Mm          , Gs^Fp       , Gs^Fp       , Ds          , Ww          , Wo          , Wo          , Wo          , Wo          
Wo          , Wo          , Wo          , Ww          , Ds          , Ds          , Gs^Fp       , Hh          , Mm          , Mm^Xm       , Mm          , Hh          , Gs^Fp       , Ds          , Ds          , Ww          , Wo          , Wo          , Wo          
Wo          , Wo          , Ww          , Ww          , Ds          , Gs^Fp       , Mm          , Hh          , Mm          , Mm^Xm       , Mm          , Hh          , Hh          , Gs^Fp       , Ds          , Ww          , Ww          , Wo          , Wo          
Wo          , Ww          , Ds          , Ds          , Gg          , Gs^Fp       , Hh          , Mm^Xm       , Ww          , Ww          , Ww          , Mm^Xm       , Hh          , Gs^Fp       , Gg          , Ds          , Ds          , Ww          , Wo          
Wo          , Ww          , Ds          , Gg          , Gg          , Gg          , Hh          , Mm          , Ww          , Ww          , Ww          , Mm          , Hh          , Gg          , Gg          , Gg          , Ds          , Ww          , Wo          
Wo          , Ww          , Ds          , 1 Kh        , Ch          , Gg          , Hh          , Mm^Xm       , Mm^Xm       , Ww          , Mm^Xm       , Mm^Xm       , Hh          , Gg          , Ch          , 2 Kh        , Ds          , Ww          , Wo          
Wo          , Ww          , Ds          , Ch          , Rr          , Gg          , Gg          , Hh          , Hh          , Ww          , Hh          , Hh          , Gg          , Gg          , Rr          , Ch          , Ds          , Ww          , Wo          
Wo          , Ww          , Ds          , Gs^Fp       , Gg          , Gs^Fp       , Gs^Fp       , Gg          , Gg          , Ww          , Gg          , Gg          , Gs^Fp       , Gg          , Rr          , Gs^Fp       , Ds          , Ww          , Wo          
Wo          , Ww          , Ds          , Gs^Fp       , Gs^Fp       , Rr          , Gs^Fp       , Gs^Fp       , Ww          , Ww          , Gs^Fp       , Gs^Fp       , Gs^Fp       , Gs^Fp       , Gg          , Gs^Fp       , Ds          , Ww          , Wo          
Wo          , Ww          , Ds          , Gs^Fp       , Gs^Fp       , Gg          , Rr          , Gg          , Ww^Bw/      , Rr          , Rr          , Gs^Fp       , Rr          , Rr          , Gs^Fp       , Gg          , Ds          , Ww          , Wo          
Wo          , Ww          , Ds          , Gg          , Gs^Fp       , Gs^Fp       , Gs^Fp       , Rr          , Ww          , Gg          , Gs^Fp       , Gg          , Gs^Fp       , Gs^Fp       , Ds          , Ds          , Ww          , Ww          , Wo          
Wo          , Ww          , Ww          , Ds          , Ds          , Gg          , Gs^Fp       , Gg          , Ww          , Gg          , Gg          , Gs^Fp       , Ds          , Ds          , Ww          , Ww          , Wo          , Wo          , Wo          
Wo          , Wo          , Wo          , Ww          , Ww          , Ds          , Ds          , Gg          , Ww          , Gg          , Ds          , Ds          , Ww          , Ww          , Wo          , Wo          , Wo          , Wo          , Wo          
Wo          , Wo          , Wo          , Wo          , Wo          , Ww          , Ww          , Ww          , Ww          , Ww          , Ww          , Ww          , Wo          , Wo          , Wo          , Wo          , Wo          , Wo          , Wo          
Wo          , Wo          , Wo          , Wo          , Wo          , Wo          , Wo          , Wo          , Wo          , Wo          , Wo          , Wo          , Wo          , Wo          , Wo          , Wo          , Wo          , Wo          , Wo          
